4444444444444444444444444444444444
5555555555555555555555555555555555
3333333333333333333333333333333333
3333333333333333333333333333333333
3333333333333333333333333333333333
3333333333333333333333333333333333
3333333333333333333333333333333333
3333333333333333333333333333333333
3333322222222222222222222222233333
3333320000000000020000000000233333
3333320000000000020000000000233333
3333320002222000020022222220233333
3333320002002000020000000220233333
3333320002002200000000000220233333
3333320002000222220000000220233333
3333320002000000000000000220233333
3333322222222222222222222222233333
3333333333333333333333333333333333
3333333333333333333333333333333333
3333333333333333333333333333333333
3333333333333333333333333333333333
3333333333333333333333333333333333
3333333333333333333333333333333333
5555555555555555555555555555555555
4444444444444444444444444444444444